1111111111111111111111111111111111111111111111111111111111111111111111111
1EP0000000000000000000000000000000000000000000000000000000000000000000001
11C0100111001110011100111011001110011100111001110011100111001110011100111
11C0100111001110011100111011001110011100111001110011100111001110011100111
11C0100111001110011100111011001110011100111001110011100111001110011100111
11C0100111001110011100111011001110011100111001110011100111001110011100111
11C0100111001110011100111011001110011100111001110011100111001110011100111
11C0100111001110011100111011001110011100111001110011100111001110011100111
11C0100111001110011100111011001110011100111001110011100111001110011100111
11C0100111001110011100111011001110011100111001110011100111001110011100111
11C0100111001110011100111011001110011100111001110011100111001110011100111
11C0100111001110011100111011001110011100111001110011100111001110011100111
1111111111111111111111111111111111111111111111111111111111111111111111111
