111111111111111111111111111111111111111111111111
1E000000000000000CCCCCCCCC0000000001111100000001
111111111111111111111111111111000000000011111111
100000000000000010000000000000001000000000000001
1CCCCCCCCCCCCCCC00000001000000000000000CCCCCCCC1
110000000000000001000000000000000CCCCCCCCCCCCCC1
110000000000000001000000000000000111111111111111
10000000000CCCCCCC0C0C0C0C0C0C0C0C0C0CC111111111
100000000000000000000100000000000000001000000001
100001000000000000000100000000000000011CCCCCCCC1
110000000000000001000000000000000100000000000001
1CCCCCCCCCCCCCCC00000001000000000000000CCCCCCCC1
110000000000000001000000000000000100000000000001
1CCCCCCCCCCC000000000000001111111111111111111111
100000000000000000000CCCCCCCCCCCCCC1000000000001
110000000000000001000000000000000100000000000001
110000000000000001000000000000000100000000000001
1100000000000000010000000000000001000000000000P1
111111111111111111111111111111111111111111111111
