111111
1E0001
100C01
1000P1
111111
